wwwwwwwwwwwwwwwwwwwwwwwwwwwwwwwwwwwwwwwwwwww
w                                         ew
w                                         ew
w                                         ew
w                                         ew
w                                         ew
w                                         ew
w                                         ew
w          w                              ew
w          w                       b      ew
w          w                              ew
w     s    w                              ew
w          w                              ew
w          w                              ew
w          w                              ew
w          w                              ew
w                                         ew
w                                         ew
w                                         ew
w                                         ew
w                                         ew
w                                         ew
w                                         ew
wwwwwwwwwwwwwwwwwwwwwwwwwwwwwwwwwwwwwwwwwwww
