w                                               w
w                                               w
w                                               w
w                                               w
w                                            wwww
w                                               w
w                                               w
wwww                                            w
w                                               w
w                                               w
wwwwww                                          w
w                                               w
w                   www                         w
w                        w                      w
w                       ww                      w
w s             w     wwww                      w
w  w      n    www                  w         e w
wwwwwww wwwwwwwwwwww  wwwwww  wwwwwwwwwwwwwwwwwww
