wwwwwwwwwwwwwwwwwwwwwwwwwwwwwwwwwwwwwwwwwwwwwwwwwwwww
w                                                  ww
w                                                  ww
w                                                  ew
w                                                  ew
w                                                  ew
w                                                  ew
w                              c                   ew
w          w                                       ew
w          w                                       ew
w          w                                       ew
w     s    w                                 a     ew
w          w                                       ew
w          w                                       ew
w          w                                       ew
w          w                                       ew
w                                                  ew
w                    k                             ew
w                                                  ew
w                                                  ew
w                                                  ew
w                                                  ew
w                                                  ew
wwwwwwwwwwwwwwwwwwwwwwwwwwwwwwwwwwwwwwwwwwwwwwwwwwwww
