wwwwwwwwwwwwwwwwwwwwwwwwwwwwwwwwwwwwwwwwwwwwwwww
w                                             ew
w                                             ew
w                                             ew
w                                         a   ew
w                                             ew
w                 w                           ew
w                 t          k                ew
w          w                                  ew
w          w                                  ew
w          w                    c             ew
w     s    w                                  ew
w          w                                  ew
w          w                                  ew
w          w                                  ew
w          w                                  ew
w                                             ew
w                                             ew
w                                             ew
w                                             ew
w                                             ew
w                                             ew
w                                             ew
wwwwwwwwwwwwwwwwwwwwwwwwwwwwwwwwwwwwwwwwwwwwwwww
