wwwwwwwwwwwwwwwwwwwwwwwwwwwwwwwwwwwwwwwwwwwwwwwwww
w                                               ew
w                                               ew
w                                               ew
w                                         a     ew
w                     w                         ew
w                     t                         ew
w                            k                  ew
w                                               ew
w s                                             ew
w    w                          c               ew
wwwwwwwwwwwwwwwwwwwwwwwwwwwwwwwwwwwwwwwwwwwwwwwwww
